b0000000000000000000000000000000c000000000000b
b00000000000000000000000000000000000000000000b
b00000000000000000000000000000000000000000000b
b00000000000000000000000p00000000000000000000b
b000000000000p000000ebbbbb0100000000000000000b
b0000p00000ebbbbb0000bbbbb0100000000000000000b
b00tbbbb0000bbbbb00000000001000000000b0000000b
b000bbbb000000000000000000010000bbbbb00000000b
b000000000000000000000000001000000000000p0000b
1111111111111111111111111111111111111111111111
1111111111111111111111111111111111111111111111